132 11 12 208 15
0 0 0 0 0 0 0 0 0 0 0 0 0 0 0 0 0 0 0 0 0 0 0 0 0 0 0 0 0 0 0 0 0 0 0 0 0 2 0 0 0 0 0 0 0 0 0 0 0 0 0 0 0 0 0 0 0 0 0 0 0 0 0 0 0 0 0 0 0 0 0 0 0 0 0 0 0 0 0 0 0 0 0 0 0 0 0 0 0 0 0 0 0 0 0 0 0 0 0 0 0 0 0 0 0 0 0 0 0 0 0 0 0 0 0 0 0 0 0 0 0 0 0 0 0 0 0 0 0 0 0 0 0 0 0 0 0 0 0 0 0 0 0 0 0 0 0 0 0 0 0 0 0 0 0 0 0 0 0 0 0 0 0 0 0 0 0 0 0 0 0 0 0 0 0 0 0 0 0 0 0 0 0 0 0 0 0 0 0 0 0 0 0 0 0 0 0 0 0 0 0 0 0 0 0 0 0 0 
2 2 2 2 2 2 2 2 2 0 2 2 2 0 0 2 2 2 2 2 2 2 2 2 2 2 2 2 2 2 2 2 2 2 2 2 2 2 2 0 2 2 2 2 2 2 0 2 2 2 2 2 2 2 2 2 2 2 2 2 2 2 2 2 0 0 0 0 0 2 2 2 2 2 0 0 2 2 2 2 2 0 0 2 2 2 6 7 8 7 8 7 8 7 8 7 8 7 8 7 8 7 8 7 8 7 8 7 8 7 8 7 8 7 8 7 8 7 8 7 8 7 8 7 8 7 8 7 8 7 8 7 8 7 8 7 8 7 8 7 8 7 8 7 8 7 8 7 8 7 8 7 8 7 8 7 8 7 8 7 8 7 8 7 8 7 8 7 8 7 8 7 8 7 8 7 8 7 8 7 8 7 8 7 8 7 8 7 8 7 8 7 8 7 8 7 8 7 9 0 0 0 0 0 0 0 0 0 
2 2 2 2 2 2 2 10 11 12 13 10 11 12 13 2 2 2 2 2 2 10 11 12 13 10 11 12 13 10 11 12 13 10 11 12 13 10 11 12 13 2 2 2 2 2 0 0 2 2 2 2 2 2 2 2 2 2 2 2 2 0 2 2 0 0 0 0 0 0 2 2 2 2 2 2 2 2 2 10 11 12 13 2 2 2 14 15 16 15 16 15 16 15 16 15 16 15 16 15 16 15 16 15 16 15 16 15 16 15 16 15 16 15 16 15 16 15 16 15 16 15 16 15 16 15 16 15 16 15 16 15 16 15 16 15 16 15 16 15 16 15 16 15 16 15 16 15 16 15 16 15 16 15 16 15 16 15 16 15 16 15 17 18 17 18 17 18 17 18 17 18 17 18 17 18 17 18 17 18 17 18 17 18 17 18 17 18 17 18 17 18 17 18 17 18 17 18 19 20 0 0 0 0 0 0 0 0 
2 2 2 2 0 0 21 22 23 24 25 22 23 24 26 0 0 0 0 0 21 22 23 24 25 22 23 24 25 22 23 24 25 22 23 24 25 22 23 24 26 2 2 2 2 2 0 0 0 0 0 0 2 2 2 2 2 2 2 2 0 0 0 0 2 2 2 2 0 0 2 2 0 0 0 2 2 0 21 22 23 24 26 0 2 2 27 28 27 28 27 28 27 28 27 28 27 28 27 28 27 28 27 28 27 28 27 28 27 28 27 28 27 28 27 28 27 28 27 28 27 28 27 28 27 28 27 28 27 28 27 28 27 28 27 28 27 28 27 28 27 28 27 28 27 28 27 28 27 28 27 28 27 28 27 28 27 28 27 28 27 28 29 7 8 7 8 7 8 7 8 7 8 7 8 7 8 7 8 7 8 7 8 7 8 7 8 7 8 7 8 7 8 7 8 7 8 7 8 7 30 31 32 33 34 35 35 35 
2 2 0 0 0 0 36 37 38 39 36 40 38 39 0 0 0 0 0 0 36 37 38 39 36 40 38 39 36 40 38 39 36 40 38 39 36 40 38 39 0 2 2 2 2 2 0 0 0 0 0 2 2 2 2 2 2 2 2 2 0 0 0 2 2 2 2 2 2 2 2 2 0 0 0 0 0 0 36 37 38 39 0 0 2 2 41 42 41 42 41 42 41 42 41 42 41 42 41 42 41 42 41 42 41 42 41 42 41 42 41 42 41 42 41 42 41 42 27 28 27 28 27 28 27 28 27 28 41 42 41 42 41 42 41 42 41 42 27 28 27 28 27 28 27 28 27 28 27 28 27 28 27 28 27 28 41 42 41 42 27 28 43 44 16 15 16 15 16 15 16 15 16 15 16 15 16 15 16 15 16 15 16 15 16 15 16 15 16 15 16 15 16 15 16 15 16 15 16 15 45 46 47 48 49 50 50 50 
0 0 51 52 52 53 52 54 51 52 52 54 51 52 51 52 52 53 52 53 52 53 52 54 51 52 52 53 52 53 52 54 52 54 51 52 52 53 52 53 51 52 52 53 52 53 52 54 0 0 2 2 0 0 0 0 51 52 52 53 52 53 52 53 52 54 0 0 0 0 0 0 0 0 51 52 52 53 52 53 52 53 52 53 52 54 55 56 55 56 55 56 55 56 55 56 55 56 55 56 55 56 55 56 55 56 55 56 55 56 55 56 55 56 55 56 55 56 27 28 27 28 27 28 27 28 27 28 55 56 55 56 55 56 55 56 55 56 27 28 27 28 27 28 27 28 27 28 27 28 27 28 27 28 27 28 55 56 55 56 27 28 27 28 27 28 27 28 27 28 27 28 27 28 27 28 27 28 27 28 27 28 27 28 27 28 27 28 27 28 27 28 27 28 27 28 27 28 27 28 27 57 58 48 49 59 59 59 
0 0 60 61 62 63 64 65 60 61 64 65 60 61 60 61 62 63 62 63 62 63 64 65 60 61 62 63 62 63 64 65 64 65 60 61 62 63 62 63 60 61 62 63 62 63 64 65 0 0 2 2 0 0 0 0 60 61 62 63 62 63 62 63 64 65 0 0 0 0 0 0 0 0 60 61 62 63 62 63 62 63 62 63 64 65 66 67 66 67 66 67 66 67 66 67 66 67 66 67 66 67 66 67 66 67 66 67 66 67 66 67 66 67 66 67 66 67 41 42 41 42 41 42 41 42 41 42 66 67 66 67 66 67 66 67 66 67 27 28 41 42 41 42 27 28 27 28 27 28 27 28 27 28 41 42 66 67 66 67 27 28 41 42 41 42 27 28 27 28 27 28 27 28 27 28 27 28 27 28 27 28 27 28 27 28 27 28 41 42 41 42 41 42 41 42 27 28 27 28 27 68 69 70 49 59 59 59 
0 0 55 56 55 56 55 56 55 56 55 56 55 56 55 56 55 56 55 56 55 56 55 56 55 56 55 56 55 56 55 56 55 56 55 56 55 56 55 56 55 56 55 56 55 56 55 56 115 116 0 0 0 0 0 118 55 56 55 56 55 56 55 56 55 56 115 0 0 0 0 0 0 118 55 56 55 56 55 56 55 56 55 56 55 56 55 56 55 56 73 74 73 74 73 74 73 74 73 74 73 74 73 74 73 74 73 74 73 74 73 74 73 74 73 74 55 56 55 56 55 56 55 56 55 56 55 56 55 56 73 74 73 74 73 74 73 74 27 28 55 56 55 56 27 28 27 28 27 28 27 28 27 28 55 56 55 56 73 74 27 28 55 56 55 56 27 28 27 28 27 28 27 28 27 28 27 28 27 28 27 28 27 28 27 28 27 28 55 56 55 56 55 56 55 56 27 28 27 28 27 75 76 77 49 59 59 59 
0 0 66 67 66 67 66 67 66 67 66 67 66 67 66 67 66 67 66 67 66 67 66 67 66 67 66 67 66 67 66 67 66 67 66 67 66 67 66 67 66 67 66 67 66 67 66 67 126 127 0 0 0 0 0 129 66 67 66 67 66 67 66 67 66 67 126 0 0 0 0 0 0 129 66 67 66 67 66 67 66 67 66 67 66 67 66 67 66 67 81 82 81 82 81 82 81 82 81 82 81 82 81 82 81 82 81 82 81 82 81 82 81 82 81 82 66 67 66 67 66 67 66 67 66 67 66 67 66 67 81 82 81 82 81 82 81 82 41 42 66 67 66 67 27 28 41 42 41 42 27 28 27 28 66 67 66 67 81 82 27 28 66 67 66 67 41 42 41 42 41 42 41 42 27 28 27 28 27 28 27 28 27 28 41 42 41 42 66 67 66 67 66 67 66 67 41 42 27 28 27 83 84 85 49 59 59 59 
86 86 73 74 73 74 73 74 73 74 55 56 55 56 55 56 73 74 73 74 73 74 73 74 73 74 55 56 55 56 73 74 73 74 73 74 73 74 73 74 73 74 73 74 73 74 73 74 86 86 86 86 86 86 86 86 73 74 73 74 73 74 73 74 73 74 86 86 86 86 86 86 86 86 73 74 73 74 73 74 73 74 73 74 73 74 73 74 73 74 73 74 73 74 73 74 73 74 73 74 55 56 55 56 55 56 55 56 55 56 55 56 55 56 73 74 73 74 73 74 73 74 73 74 73 74 73 74 73 74 73 74 73 74 73 74 55 56 55 56 55 56 73 74 27 28 55 56 55 56 27 28 27 28 73 74 73 74 73 74 27 28 73 74 55 56 55 56 55 56 55 56 55 56 27 28 27 28 27 28 27 28 27 28 55 56 55 56 73 74 73 74 73 74 73 74 55 56 27 28 27 87 88 89 90 91 91 91 
86 86 81 82 81 82 81 82 81 82 66 67 66 67 66 67 81 82 81 82 81 82 81 82 81 82 66 67 66 67 81 82 81 82 81 82 81 82 81 82 55 56 55 56 55 56 81 82 86 86 86 86 86 86 86 86 81 82 81 82 81 82 81 82 81 82 86 86 86 86 86 86 86 86 81 82 81 82 81 82 81 82 81 82 81 82 81 82 81 82 81 82 81 82 55 56 55 56 81 82 66 67 66 67 66 67 66 67 66 67 66 67 66 67 81 82 81 82 81 82 81 82 81 82 81 82 81 82 81 82 81 82 55 56 81 82 66 67 66 67 66 67 81 82 27 28 66 67 66 67 41 42 41 42 81 82 81 82 55 56 27 28 81 82 66 67 66 67 66 67 66 67 66 67 27 28 27 28 41 42 41 42 27 28 66 67 66 67 81 82 55 56 55 56 55 56 66 67 41 42 27 92 93 94 49 59 59 59 
86 86 73 74 73 74 73 74 73 74 73 74 73 74 73 74 55 56 73 74 73 74 55 56 73 74 73 74 73 74 73 74 73 74 73 74 73 74 73 74 96 97 96 97 96 97 73 74 86 86 86 86 86 86 86 95 73 74 73 74 73 74 73 74 73 74 98 86 86 86 86 86 86 86 73 74 73 74 73 74 73 74 73 74 73 74 73 74 73 74 73 74 73 74 96 97 96 97 73 74 73 74 73 74 73 74 73 74 73 74 73 74 73 74 73 74 73 74 73 74 55 56 55 56 73 74 55 56 55 56 73 74 96 97 73 74 73 74 73 74 73 74 73 74 27 28 73 74 55 56 55 56 55 56 73 74 73 74 96 97 27 28 73 74 73 74 73 74 73 74 73 74 73 74 27 28 27 28 55 56 55 56 27 28 73 74 73 74 73 74 73 74 73 74 73 74 73 74 55 56 27 99 100 101 49 59 59 59 
86 86 103 103 103 103 103 103 103 103 81 82 81 82 81 82 66 67 81 82 81 82 66 67 103 103 81 82 81 82 103 103 103 103 103 103 81 82 81 82 81 82 81 82 81 82 106 103 107 86 86 86 86 86 86 86 103 103 103 103 103 103 103 103 103 103 86 86 86 86 86 86 86 86 104 104 104 104 81 82 81 82 81 82 81 82 81 82 81 82 81 82 81 82 81 82 81 82 104 104 81 82 81 82 81 82 81 82 81 82 81 82 81 82 81 82 81 82 81 82 66 67 66 67 81 82 66 67 66 67 81 82 81 82 81 82 81 82 81 82 81 82 81 82 27 28 81 82 66 67 66 67 66 67 81 82 81 82 81 82 27 28 81 82 81 82 81 82 81 82 81 82 81 82 41 42 27 28 66 67 66 67 27 28 81 82 81 82 81 82 81 82 81 82 81 82 81 82 66 67 41 108 109 110 49 59 59 59 
86 86 86 86 86 86 86 86 86 102 103 103 103 103 103 103 103 103 55 56 56 55 103 103 107 102 103 103 103 103 107 86 86 86 86 102 103 103 55 56 55 56 103 103 103 103 107 86 86 86 86 86 86 86 86 86 86 86 86 86 86 86 86 86 86 86 86 86 86 86 86 86 86 86 86 86 86 102 104 104 104 104 104 104 104 104 104 104 55 56 55 56 55 56 104 104 104 104 107 102 104 104 104 104 104 104 104 104 55 56 55 56 55 56 55 56 55 56 55 56 73 74 73 74 73 74 73 74 73 74 73 74 73 74 73 74 73 74 73 74 73 74 73 74 27 28 55 56 73 74 73 74 73 74 73 74 55 56 73 74 27 28 73 74 73 74 73 74 73 74 55 56 55 56 55 56 27 28 73 74 73 74 27 28 73 74 73 74 55 56 55 56 55 56 55 56 55 56 55 56 55 56 55 90 113 59 59 59 
86 86 86 86 86 86 86 86 86 86 86 86 86 86 86 86 86 102 103 103 103 103 107 86 86 86 86 86 86 86 86 86 86 86 86 86 86 86 103 103 103 103 107 86 86 86 86 86 86 86 86 86 86 86 86 86 86 86 86 86 86 86 86 86 86 86 86 86 86 86 86 86 86 86 86 86 86 86 86 86 86 86 86 86 86 86 86 102 104 104 104 104 104 104 107 86 86 86 86 86 86 86 86 86 86 86 86 102 104 104 104 67 66 67 66 67 66 67 66 67 81 82 81 82 81 82 81 82 81 82 81 82 81 82 81 82 81 82 81 82 81 82 81 82 27 28 66 67 81 82 81 82 81 82 81 82 66 67 81 82 27 28 81 82 81 82 81 82 81 82 66 67 66 67 66 67 27 28 81 82 81 82 27 28 81 82 81 82 66 67 66 67 66 67 66 67 66 67 66 67 66 67 66 49 59 59 59 59